NO /path_to_the_north_texture
SO /path_to_the_south_texture
WE /path_to_the_west_texture
EA /path_to_the_east_texture

F 0,0,0
C 148,0,211

1111111
1000001
1000001
10000N1
1111111
